1 1 1 1 1 1 1 1 1 1 1 1 1 1 1 1 1 1 1 1 1 1 1 1 1 1 1 1 1 1 1 1 1 1 1 1 1 1 1 1 1 1 1 1 1 1 1 1 1 1 
1 0 0 0 3 5 5 0 0 0 4 1 1 5 5 5 5 1 1 4 0 0 0 0 1 1 0 0 0 0 4 1 1 5 5 5 5 1 1 4 0 0 0 5 5 3 0 0 0 1 
1 0 0 0 0 5 5 0 0 0 0 1 1 5 5 5 5 1 1 0 0 0 0 0 1 1 0 0 0 0 0 1 1 5 5 5 5 1 1 0 0 0 0 5 5 0 0 0 0 1 
1 0 0 0 0 5 5 0 0 0 0 1 1 1 1 1 1 1 1 0 0 0 0 0 5 5 0 0 0 0 0 1 1 1 1 1 1 1 1 0 0 0 0 5 5 0 0 0 0 1 
1 0 0 1 1 1 1 0 0 0 0 1 1 1 1 1 1 1 1 0 0 0 0 0 5 5 0 0 0 0 0 1 1 1 1 1 1 1 1 0 0 0 0 1 1 1 1 0 0 1 
1 0 0 1 1 1 1 0 0 0 0 0 0 0 0 0 0 0 0 0 0 0 0 0 1 1 0 0 0 0 0 0 0 0 0 0 0 0 0 0 0 0 0 1 1 1 1 0 0 1 
1 0 0 1 1 2 0 0 0 0 0 0 0 0 0 0 0 0 0 0 0 0 0 0 0 0 0 0 0 0 0 0 0 0 0 0 0 0 0 0 0 0 0 0 2 1 1 0 0 1 
1 0 0 1 1 1 1 0 0 0 0 0 1 1 1 1 1 1 0 0 0 0 0 0 5 5 0 0 0 0 0 0 1 1 1 1 1 1 0 0 0 0 0 1 1 1 1 0 0 1 
1 0 0 1 1 1 1 0 0 0 0 0 1 1 1 1 1 1 0 0 0 0 0 0 5 5 0 0 0 0 0 0 1 1 1 1 1 1 0 0 0 0 0 1 1 1 1 0 0 1 
1 0 0 0 10 1 1 0 0 0 0 0 8 5 1 1 6 0 0 0 0 0 0 0 1 1 0 0 0 0 0 0 0 6 1 1 5 8 0 0 0 0 0 1 1 10 0 0 0 1 
1 0 0 1 1 1 1 0 0 0 0 0 0 5 1 1 0 0 0 0 0 0 0 0 1 1 0 0 0 0 0 0 0 0 1 1 5 0 0 0 0 0 0 1 1 1 1 0 0 1 
1 0 0 1 1 1 1 0 0 0 0 0 0 5 1 1 0 0 0 0 0 0 0 0 5 5 0 0 0 0 0 0 0 0 1 1 5 0 0 0 0 0 0 1 1 1 1 0 0 1 
1 0 0 1 1 12 0 0 0 0 0 0 9 5 1 1 3 0 0 0 0 0 0 0 5 5 0 0 0 0 0 0 0 3 1 1 5 9 0 0 0 0 0 0 12 1 1 0 0 1 
1 0 0 1 1 1 1 0 0 0 0 0 1 1 1 1 1 1 0 0 0 0 0 0 1 1 0 0 0 0 0 0 1 1 1 1 1 1 0 0 0 0 0 1 1 1 1 0 0 1 
1 0 0 1 1 1 1 0 0 0 0 0 1 1 1 1 1 1 0 0 0 0 0 0 1 1 0 0 0 0 0 0 1 1 1 1 1 1 0 0 0 0 0 1 1 1 1 0 0 1 
1 0 0 0 0 0 0 0 0 0 0 0 0 0 0 0 0 0 0 0 0 0 0 0 0 0 0 0 0 0 0 0 0 0 0 0 0 0 0 0 0 0 0 0 0 0 0 0 0 1 
1 0 0 0 0 0 0 0 0 0 0 0 0 0 0 0 0 0 0 0 0 0 0 0 0 0 0 0 0 0 0 0 0 0 0 0 0 0 0 0 0 0 0 0 0 0 0 0 0 1 
1 0 0 0 0 0 0 0 0 0 0 0 0 0 0 0 0 0 0 0 0 0 0 0 0 0 0 0 0 0 0 0 0 0 0 0 0 0 0 0 0 0 0 0 0 0 0 0 0 1 
1 0 0 0 0 0 0 0 0 0 0 0 0 0 0 0 0 0 0 0 0 0 0 0 0 0 0 0 0 0 0 0 0 0 0 0 0 0 0 0 0 0 0 0 0 0 0 0 0 1 
1 0 0 0 0 0 0 0 0 0 0 0 0 0 0 0 0 0 0 0 0 0 0 0 0 0 0 0 0 0 0 0 0 0 0 0 0 0 0 0 0 0 0 0 0 0 0 0 0 1 
1 0 0 0 0 0 0 0 0 0 0 0 0 0 0 0 0 0 0 0 0 0 0 0 0 0 0 0 0 0 0 0 0 0 0 0 0 0 0 0 0 0 0 0 0 0 0 0 0 1 
1 0 3 1 1 0 0 1 1 0 0 1 1 0 0 1 1 0 0 0 0 1 1 1 5 0 1 1 1 0 0 0 0 1 1 0 0 1 1 0 0 1 1 0 0 1 1 3 0 1 
1 0 0 1 1 0 0 1 1 0 0 1 1 0 0 1 1 0 0 0 0 1 1 1 5 0 1 1 1 0 0 0 0 1 1 0 0 1 1 0 0 1 1 0 0 1 1 0 0 1 
1 0 0 0 0 0 0 0 0 0 0 0 0 0 0 0 0 0 0 0 0 1 1 5 5 0 5 1 1 0 0 0 0 0 0 0 0 0 0 0 0 0 0 0 0 0 0 0 0 1 
1 0 0 5 5 0 0 5 5 0 0 5 5 0 0 5 5 0 0 0 0 0 0 0 0 11 5 5 5 0 0 0 0 0 0 0 0 0 0 0 0 0 0 0 0 0 0 0 0 1 
1 0 0 0 0 0 0 0 0 0 0 0 0 0 0 0 0 0 0 0 0 5 5 5 7 0 0 0 0 0 0 5 5 0 0 5 5 0 0 5 5 0 0 5 5 0 0 0 0 1 
1 0 0 0 0 0 0 0 0 0 0 0 0 0 0 0 0 0 0 0 0 1 1 5 0 5 5 1 1 0 0 0 0 0 0 0 0 0 0 0 0 0 0 0 0 0 0 0 0 1 
1 0 0 0 0 1 1 0 0 1 1 0 0 1 1 0 0 1 1 0 0 1 1 1 0 5 1 1 1 0 0 1 1 0 0 1 1 0 0 1 1 0 0 1 1 0 0 0 0 1 
1 0 0 0 3 1 1 0 0 1 1 0 0 1 1 0 0 1 1 0 0 1 1 1 0 5 1 1 1 0 0 1 1 0 0 1 1 0 0 1 1 0 0 1 1 3 0 0 0 1 
1 0 0 0 0 0 0 0 0 0 0 0 0 0 0 0 0 0 0 0 0 0 0 0 0 0 0 0 0 0 0 0 0 0 0 0 0 0 0 0 0 0 0 0 0 0 0 0 0 1 
1 0 0 0 0 0 0 0 0 0 0 0 0 0 0 0 0 0 0 0 0 0 0 0 0 0 0 0 0 0 0 0 0 0 0 0 0 0 0 0 0 0 0 0 0 0 0 0 0 1 
1 0 0 0 0 0 0 0 0 0 0 0 0 0 0 0 0 0 0 0 0 0 0 0 0 0 0 0 0 0 0 0 0 0 0 0 0 0 0 0 0 0 0 0 0 0 0 0 0 1 
1 0 0 0 0 0 0 0 0 0 0 0 0 0 0 0 0 0 0 0 0 0 0 0 0 0 0 0 0 0 0 0 0 0 0 0 0 0 0 0 0 0 0 0 0 0 0 0 0 1 
1 0 0 0 0 0 0 0 0 0 0 0 0 0 0 0 0 0 0 0 0 0 0 0 0 0 0 0 0 0 0 0 0 0 0 0 0 0 0 0 0 0 0 0 0 0 0 0 0 1 
1 0 0 0 0 0 0 0 0 0 0 0 0 0 0 0 0 0 0 0 0 0 0 0 0 0 0 0 0 0 0 0 0 0 0 0 0 0 0 0 0 0 0 0 0 0 0 0 0 1 
1 0 0 1 1 1 1 0 0 0 0 0 1 1 1 1 1 1 0 0 0 0 0 0 1 1 0 0 0 0 0 0 1 1 1 1 1 1 0 0 0 0 0 1 1 1 1 0 0 1 
1 0 0 1 1 1 1 0 0 0 0 0 1 1 1 1 1 1 0 0 0 0 0 0 1 1 0 0 0 0 0 0 1 1 1 1 1 1 0 0 0 0 0 1 1 1 1 0 0 1 
1 0 0 1 1 12 0 0 0 0 0 0 8 5 1 1 3 0 0 0 0 0 0 0 5 5 0 0 0 0 0 0 0 3 1 1 5 8 0 0 0 0 0 0 12 1 1 0 0 1 
1 0 0 1 1 1 1 0 0 0 0 0 0 5 1 1 0 0 0 0 0 0 0 0 5 5 0 0 0 0 0 0 0 0 1 1 5 0 0 0 0 0 0 1 1 1 1 0 0 1 
1 0 0 1 1 1 1 0 0 0 0 0 0 5 1 1 0 0 0 0 0 0 0 0 1 1 0 0 0 0 0 0 0 0 1 1 5 0 0 0 0 0 0 1 1 1 1 0 0 1 
1 0 0 0 10 1 1 0 0 0 0 0 9 5 1 1 6 0 0 0 0 0 0 0 1 1 0 0 0 0 0 0 0 6 1 1 5 9 0 0 0 0 0 1 1 10 0 0 0 1 
1 0 0 1 1 1 1 0 0 0 0 0 1 1 1 1 1 1 0 0 0 0 0 0 5 5 0 0 0 0 0 0 1 1 1 1 1 1 0 0 0 0 0 1 1 1 1 0 0 1 
1 0 0 1 1 1 1 0 0 0 0 0 1 1 1 1 1 1 0 0 0 0 0 0 5 5 0 0 0 0 0 0 1 1 1 1 1 1 0 0 0 0 0 1 1 1 1 0 0 1 
1 0 0 1 1 2 0 0 0 0 0 0 0 0 0 0 0 0 0 0 0 0 0 0 0 0 0 0 0 0 0 0 0 0 0 0 0 0 0 0 0 0 0 0 2 1 1 0 0 1 
1 0 0 1 1 1 1 0 0 0 0 0 0 0 0 0 0 0 0 0 0 0 0 0 1 1 0 0 0 0 0 0 0 0 0 0 0 0 0 0 0 0 0 1 1 1 1 0 0 1 
1 0 0 1 1 1 1 0 0 0 0 1 1 1 1 1 1 1 1 0 0 0 0 0 5 5 0 0 0 0 0 1 1 1 1 1 1 1 1 0 0 0 0 1 1 1 1 0 0 1 
1 0 0 0 0 5 5 0 0 0 0 1 1 1 1 1 1 1 1 0 0 0 0 0 5 5 0 0 0 0 0 1 1 1 1 1 1 1 1 0 0 0 0 5 5 0 0 0 0 1 
1 0 0 0 0 5 5 0 0 0 0 1 1 5 5 5 5 1 1 0 0 0 0 0 1 1 0 0 0 0 0 1 1 5 5 5 5 1 1 0 0 0 0 5 5 0 0 0 0 1 
1 0 0 0 3 5 5 0 0 0 4 1 1 5 5 5 5 1 1 4 0 0 0 0 1 1 0 0 0 0 4 1 1 5 5 5 5 1 1 4 0 0 0 5 5 3 0 0 0 1 
1 1 1 1 1 1 1 1 1 1 1 1 1 1 1 1 1 1 1 1 1 1 1 1 1 1 1 1 1 1 1 1 1 1 1 1 1 1 1 1 1 1 1 1 1 1 1 1 1 1 